m1-1-4-1 1-4-1
m1-2-6-4 2-6-4
m1-3-2-3 3-2-3
m1-3-2-7 3-2-7
m1-3-3-8 3-3-8
m1-3-5-8 3-5-8
m1-8-4-6 8-4-6
m1-9-2-6 9-2-6
m1-9-5-0 9-5-0
m1-9-7-9 9-7-9
